{  
   "tiles":
   [
    	0, 0, 0, 0, 0, 0, 0, 0, 0, 0,  
    	0, 0, 0, 0, 0, 0, 0, 0, 0, 0,
    	0, 0, 0, 0, 0, 0, 0, 0, 0, 0,
    	0, 0, 0, 8, 1, 1, 1, 0, 0, 0,
	0, 0, 0, 1, 1, 1, 1, 0, 0, 0,
	0, 0, 0, 1, 1, 1, 1, 0, 0, 0,
	0, 0, 0, 2, 1, 1,16, 0, 0, 0,
	0, 0, 0, 0, 0, 0, 0, 0, 0, 0,
	0, 0, 0, 0, 0, 0, 0, 0, 0, 0,
	0, 0, 0, 0, 0, 0, 0, 0, 0, 0
   ]
}