{  
   "tiles":
   [
    	0, 0, 0, 0,14, 0, 0, 0, 0, 0,  
    	0, 0, 1, 0, 1, 0, 1, 1, 0, 0,
    	0, 2, 1, 1, 1, 1, 1, 1, 0, 0,
    	0, 0, 1, 1, 3, 1, 1, 1, 1, 0,
	0, 0, 0, 0, 1, 1, 1, 0, 0, 0,
	0, 0, 1, 1, 1, 0, 1, 1, 0, 0,
	0, 1, 1, 1, 1, 1, 1, 6, 0, 0,
	0, 1, 1, 1, 1, 1, 1, 0, 0, 0,
	0, 0,11, 0, 0, 0, 0, 0, 0, 0,
	0, 0,19, 0, 0, 0, 0, 0, 0, 0
   ]
}