{  
   "tiles":
   [
    	0, 0, 0, 1, 1, 1, 1, 0, 0, 0,  
    	0, 0, 0, 1, 2, 1, 1, 0, 0, 0,
    	0, 1, 1, 1, 1, 1, 1,19, 0, 0,
    	0, 1, 1, 1, 0, 1, 1, 1, 1, 0,
	1, 1, 1, 0,11, 0, 1, 1, 1, 0,
	1, 1, 1,11,11, 0, 1, 1, 3, 0,
	1, 1, 1, 0,11, 0, 1, 1, 3, 0,
	0, 1, 1, 1, 0, 1, 1, 1, 3, 0,
	0, 1, 1, 1, 1, 1, 1, 1, 3, 0,
	0, 0, 0, 0, 0, 0, 0, 0, 0, 0
   ]
}