{  
   "tiles":
   [
    	0,17, 0, 0,15,17, 0,15, 0, 0,  
    	0, 1, 0, 7, 1, 1, 1, 1, 7, 0,
       15, 1, 9, 1, 1, 1, 1, 1, 9, 0,  
    	0, 1, 1, 1, 1, 1, 1, 1, 1,17,
	0, 7, 1, 1, 1, 1, 1, 9, 1, 0,  
    	0, 1, 1, 1, 9, 1, 1, 1, 0, 0,
       17, 1, 1, 1, 1, 1, 1, 1, 1, 0,  
    	0, 1, 7, 1, 1, 1, 1, 1, 1,17,
	0, 0, 1, 9, 1, 7, 1, 0, 1, 0,  
    	0, 0, 0,15, 0, 0, 2, 0,15, 0,
   ]
}