{  
   "tiles":
   [
    	1, 1, 5, 1, 1, 1, 0,14, 5, 0,  
    	3, 1, 0, 1, 3, 1, 1, 1,11, 1,
    	1,12,11,15, 1, 1, 1, 1, 1, 1,  
    	0, 1, 1, 0,14, 1, 1, 1, 1, 4,
	6, 5, 1, 1, 0,12, 0, 1, 6, 1,  
    	1, 1, 1, 1,15, 0,13, 1, 1, 7,
	7, 1, 1, 1, 0,14, 0, 6, 1, 1,  
    	1, 0, 5, 1, 0, 1, 1, 1, 1, 1,
       11, 1, 1, 1,14, 1, 1, 0,13,13,  
    	1, 1, 6, 0, 4, 0, 2,13,19, 3,
   ]
}