{  
   "tiles":
   [
        1, 1, 1, 1, 1, 1, 0, 1, 1,10,  
    	6, 1, 1, 0, 1, 1, 1, 1, 0, 0,
    	0, 0, 1, 1, 1, 0, 1, 1, 1, 1,  
    	1, 1, 0, 1, 1, 1, 1, 1, 1, 0,
	1, 1, 1, 1, 0, 1, 1, 1, 1, 0,  
    	1, 1, 1, 1, 1, 1, 1, 1, 1, 1,
	0, 1, 1, 1, 1, 1, 1, 0, 1, 1,  
    	1, 0, 1, 2,14, 1, 1, 1, 1, 1,
	1, 1, 1, 1, 1, 1, 1, 1,18, 1,  
    	1, 1, 1, 1, 0, 1, 1, 1, 0, 1,
   ]
}