{  
   "tiles":
   [
    	3, 0,14, 0, 1, 1, 1, 1, 1, 1,  
    	4, 0, 1, 1, 1, 1, 1, 1, 0, 1,
    	5, 0, 1, 1, 1, 1, 1, 1, 1, 1,  
    	6, 1, 1, 1, 1, 1, 1, 1, 1, 1,
	8, 0, 1, 2, 1, 0, 1, 1, 1, 1,  
    	0, 1, 1, 1, 1,16, 1, 1, 1, 0,
       13, 1, 1, 1, 1, 1, 1, 1, 1, 1,  
    	0, 0, 1,12, 0, 1, 1, 1, 1, 1,
       19,11, 1, 1, 1, 1, 1, 0, 1, 1,  
        0, 0, 1, 1, 1, 1, 1, 1, 1, 1,
   ]
}