{  
   "tiles":
   [
    	0, 9, 0, 0, 0, 0, 0, 0, 1, 1,  
    	9, 1, 1, 1, 1, 1, 1, 1, 1, 1,
    	0, 1, 1, 1, 1, 1, 1, 1, 1, 0,
    	0, 1, 1, 2, 1, 1, 1, 1, 1, 0,
	0, 1, 1, 1,17,18, 1, 1, 1, 0,
	0, 1, 1, 1,18,17, 1, 1, 1, 0,
	0, 1, 1, 1, 1, 1, 1, 1, 1, 0,
	0, 1, 1, 1, 1, 0, 1, 1, 1, 0,
	1, 1, 1, 1, 1, 1, 1, 1, 1,10,
	1, 1, 0, 0, 0, 0, 0, 0,10, 0
   ]
}