{  
   "tiles":
   [
    	0, 0, 0, 0, 0, 0, 0, 0, 0, 0,  
    	0, 7, 1, 1, 1, 1, 1, 1, 8, 0,
    	0, 1, 1, 1, 1,16, 0, 1, 1, 0,
    	0, 1, 1,15, 1, 1, 1, 1, 1, 0,
	0, 1, 0, 1, 1, 1,15, 1, 1, 0,
	0, 1, 1, 1, 1, 1, 1, 1, 1, 0,
	0, 1, 1, 1, 0, 1, 1, 1, 1, 0,
	0, 1,16, 1, 1, 2, 1, 1, 1, 0,
	0, 8, 1, 1, 1, 1, 1, 1, 7, 0,
	0, 0, 0, 0, 0, 0, 0, 0, 0, 0
   ]
}