{  
   "tiles":
   [
    	1, 1,14, 1,15, 0, 1, 1, 1, 1,  
    	1, 1, 1, 1, 1, 1, 1, 1, 1, 1,
    	1,13, 1, 1, 1, 1, 1, 2, 1, 1,
    	1, 1, 1,18, 1, 1, 1, 1, 1, 1,
	1, 1, 1, 1, 1, 1,11, 1, 1, 1,
	1, 1, 1, 1, 1, 1, 1,17, 1, 0,
	1, 1,12, 1, 1, 1, 1, 1, 1, 1,
	1, 1, 1, 1, 1, 1, 1, 1, 1, 1,
	1, 1, 1, 1,16, 1, 1, 1, 1, 1,
	1,19,10, 9, 8, 7, 6, 5, 4, 3
   ]
}