{  
   "tiles":
   [
    	2, 1, 1,18, 1, 5, 1, 1,18, 8,  
    	8,18, 1, 1, 1,13, 8, 1, 1, 1,
    	1,10, 1,13, 1, 1, 1,13, 1, 1,  
    	5, 1, 1, 1, 1,18, 1, 1,10, 1,
	1, 1,13,16,18, 1, 1, 1, 1, 1,  
    	1,10, 1,10, 1, 5,10, 1, 1,16,
	1, 1,18, 1, 1, 1,18, 1, 8, 1,  
    	5, 1, 1, 1,13, 1, 1, 1, 1, 5,
	1,16, 1, 1, 1, 1, 5, 1,13, 1,  
    	1,10, 8,16, 1,10, 1,16, 1, 1,
   ]
}


300.000