{  
   "tiles":
   [
    	0, 0, 0, 0, 0, 0, 0, 0, 0, 0,  
    	0, 1, 0, 1, 1, 1, 1,10, 5, 0,
    	0, 1, 2, 0, 0,18, 1, 1, 1, 0,
    	0, 1,13, 1, 1, 0,12, 0, 1, 0,
	0, 1, 1,18, 1, 1, 1, 1, 1, 0,
	0, 1,10, 1, 1,12, 1,13, 1, 0,
	0, 1, 1, 1, 1, 0, 1, 1, 5, 0,
	0, 0, 1, 1, 1, 1, 1, 1, 0, 0,
	0, 4, 1, 1, 0, 1, 0, 1, 4, 0,
	0, 0, 0, 0, 0, 0, 0, 0, 0, 0
   ]
}