{  
   "tiles":
   [
    	4, 1, 4, 1, 1, 1, 1, 1, 4, 1,  
    	1, 1, 4, 1,12, 1, 1, 1, 1, 4,
    	1,12, 1, 1, 1, 1, 1,12, 1, 1,  
    	1, 1, 1, 1,12, 1, 1, 1, 1, 1,
	4, 1, 1, 1, 1, 1,12, 1, 1, 4,  
    	1, 1, 1,12, 1, 1, 1, 1, 1, 1,
	1, 1, 1, 2, 1,12, 1, 1, 1, 1,  
    	1,12, 1, 1, 1, 1, 1,12, 1, 1,
	1, 1, 1, 1, 1,12, 1, 1, 1, 7,  
    	4, 1, 4, 1, 1, 1, 1, 1, 4,15
   ]
}