{  
   "tiles":
   [
    	2, 1, 0, 1, 1, 1, 1, 0, 1, 6,  
    	1, 1, 0,11, 1, 0, 1, 1, 1, 1,
    	0, 1, 1, 0, 0, 1, 1, 1, 0, 0,
    	0, 0, 1, 1, 1, 1, 0, 1,19, 0,
       12, 0, 1, 1, 1, 1, 0, 1, 0, 0,
	1, 1, 1, 0, 0, 1, 1, 1, 0,13,
	0, 0, 0, 1, 1, 1, 1, 0, 0, 1,
	0, 0, 1, 1, 1, 1, 0, 1, 0, 1,
	3,14, 1, 1, 0, 1, 1, 1, 1, 1,  
    	4, 5, 0, 1, 1, 1, 1, 1, 1, 1
   ]
}