{  
   "tiles":
   [
    	1, 1, 1, 1, 1, 1, 1, 1, 1,26,  
    	1,26, 1, 1, 1, 1, 1, 1, 1, 1,
    	1, 1, 1, 1, 1, 1,26, 1, 1, 1,  
    	1, 1,26, 1, 1,11, 1, 1, 1, 1,
        1, 1, 1, 1, 1, 1, 1, 1, 1, 1,  
    	0, 0, 0, 0, 1, 2, 1,11, 1, 1,
		3, 1,26, 1, 1, 1, 1, 1, 1, 1,  
    	0, 0, 0, 0, 1, 1, 1, 1, 1, 1,
		3, 1,26, 1, 1, 1, 1, 1, 1, 1,  
    	0, 0, 0, 0, 1, 1, 1, 1, 1, 1
   ]
}