{  
   "tiles":
   [
    	1, 1, 1, 1, 1, 1, 1, 1, 1, 1,  
    	1, 1, 1, 1,26, 1, 1, 1, 1, 1,
    	1, 1,26, 1, 1, 1, 1, 1, 1, 0,  
    	1, 1, 1, 6, 0,26, 0, 4, 1, 1,
        1, 1, 1, 0, 0,13, 0, 0, 1, 1,  
    	1, 1, 1,26,12, 2,15,26, 1, 1,
	1, 1, 1, 0, 0,14, 0, 0, 1, 1,  
    	1, 1, 1, 7, 0, 1, 0, 5, 1, 1,
	1, 1, 1, 1, 1, 1, 1, 1, 1, 1,  
    	1,26, 1, 1, 1, 1,26, 1, 1, 1
   ]
}