{  
   "tiles":
   [
    	1, 1, 1, 9, 0, 3, 1, 1, 1, 8,  
    	1, 1, 1, 1, 0, 1, 1, 0,26, 0,
       11, 0, 1,12,26, 1, 1, 1, 1,13,  
       26, 0,26, 0, 0, 0, 1,16, 1, 1,
        6, 0, 1, 1,26, 1, 1, 1, 0, 1,  
    	1, 1, 1, 1, 0, 0, 0, 0, 0, 1,
	1, 1, 1, 4, 1, 1,26, 1, 0, 2,  
    	1, 1, 0, 1, 1, 1,26, 1, 1,14,
	1,18, 0,15, 1, 0, 0, 0, 1,17,  
    	5, 1, 0,10, 1, 1,26, 1, 7, 1
   ]
}