{  
   "tiles":
   [
    	0, 0, 0, 0, 0, 0, 0, 0, 0, 0,  
    	0, 0, 0, 0, 0, 0, 0, 0, 0, 0,
       16,26,15, 9, 1, 8, 0, 1, 1,16,  
    	1, 0, 0, 0, 1, 1, 0,26, 0, 0,
        1, 1, 1,26, 7, 1, 1, 1, 1, 1,  
    	1, 1, 1,26, 1, 1,26, 1, 1, 8,
	1, 0, 1, 0,26, 0, 0, 0, 0, 1,  
        1,26, 1, 1,15, 9, 0, 2,17, 1,
	0, 0, 7, 0, 0, 0, 0, 0, 0, 0,  
    	0, 0,17, 0, 0, 0, 0, 0, 0, 0
   ]
}