{  
   "tiles":
   [
    	0, 0, 0, 0, 0, 0, 0, 0, 0, 0,  
    	0, 0, 0, 1, 0, 1, 0, 0, 0, 0,
    	0, 0, 2, 1, 1, 1, 1,12, 0, 0,
    	0, 0,20, 5, 1, 1, 1,20, 0, 0,
	0, 1, 1, 1, 1, 3, 1,13, 0, 0,
	0, 0, 1, 1, 1, 1, 1,20, 0, 0,
	0, 0, 1, 1, 4, 1, 1,11, 0, 0,
	0, 0,20, 1, 1, 1, 1,20, 0, 0,
	0, 0, 0, 0, 0, 1, 0, 0, 0, 0,
	0, 0, 0, 0, 0, 0, 0, 0, 0, 0
   ]
}