{  
   "tiles":
   [
    	1, 1,14, 9, 0, 1, 1, 1,18, 7,  
    	1, 0, 0, 0, 0, 1, 2, 1, 0, 0,
    	1, 0, 3,12, 1, 1, 1, 1, 1, 1,  
        1, 0, 0, 0, 1, 1, 1, 1, 1, 1,
        1,17, 5, 0, 1, 0, 0, 0, 1, 1,  
    	1,26, 0, 0, 1, 0, 6,15, 1, 0,
	1, 1, 1, 1, 1, 0, 0, 0, 1,16,  
       19, 1, 1, 1, 1, 0, 4, 0, 1, 0,
       11, 0, 1, 1, 1, 0,13, 0, 1, 1,  
    	8, 0,10, 1, 1,26, 1, 1, 1, 1
   ]
}