{  
   "tiles":
   [
    	1,18, 1, 1,13, 1, 1, 0,10, 1,  
        5,14, 1, 1, 1, 1, 4, 0, 9, 1,
    	0, 0, 1, 1, 1, 1, 0, 0,12, 1,  
    	1, 1, 1, 1, 1, 1, 1, 1, 1, 1,
        1, 1, 1, 0, 0, 1, 1, 1, 1,21,  
    	1, 1, 1,11, 0,26,26,26,26,26,
       17, 1, 1, 1, 1, 1, 1, 1, 1, 1,  
        1, 1, 1, 1, 1, 1, 7, 1, 1, 1,
	1, 1, 1,15, 1, 1, 0, 0, 1, 1,  
    	1, 8, 0, 6, 0, 1, 0, 2,16, 1
   ]
}