{  
   "tiles":
   [
       13, 0, 1, 1, 1, 1, 1, 1, 1,21,  
    	1, 0, 1, 1,15, 0, 0, 1, 1, 1,
    	1,15, 1, 1, 0, 1, 1, 1, 1, 1,  
    	0, 0, 1, 1, 0, 1, 1, 1, 2, 1,
        1, 1, 1, 1, 1, 1, 1, 1, 1, 1,  
    	1, 1, 1, 1, 1, 1, 1, 1, 1, 1,
	1, 0, 0, 0, 1, 7, 1,15, 0, 1,  
    	1, 0, 7, 1, 1, 1, 1, 0, 0, 1,
	1,15, 1, 1, 1, 1, 1, 1, 1, 1,  
    	7, 0, 1, 1, 1, 0, 7, 1, 1, 0
   ]
}