{  
   "tiles":
   [
    	6,16, 1, 8, 1, 0, 1,14, 1, 1,  
       16, 1, 1, 1, 8, 1, 1, 0, 0,16,
        1, 8, 1, 6, 1, 1, 1, 0,16, 6,  
    	6, 1, 1, 0, 0,14,14, 0, 0,16,
        1, 1, 1,18, 0, 1, 0, 1, 1, 1,  
    	8, 0, 0, 0, 0, 1, 8, 6, 1, 1,
	0, 1, 1, 1, 1, 0, 1, 1, 1, 0,  
       14, 1, 6, 1, 1,14, 1, 1, 6, 8,
       16,14, 1, 8, 1, 0, 0, 0, 0, 1,  
       21,16,14, 1, 8, 0, 2,14,16, 6
   ]
}