{  
   "tiles":
   [
    	1, 1,13, 1, 1,26, 1, 1,13, 9,  
    	9, 0,26, 1, 1, 1,26,26, 0, 0,
    	0, 1, 1, 1, 0, 0, 1, 1, 1, 1,  
       11, 1, 1, 1, 1, 0, 1, 1, 1, 2,
       26,26,26,26,26,26,26,26, 0, 0,  
    	1, 1, 1,26, 1, 1, 1, 1, 0, 1,
	1, 1,26, 9,13, 1, 1, 1, 0, 1,  
    	1,26, 0, 0, 1, 1,19, 1, 1,26,
       26,17,17, 0, 1, 1, 0, 0,17, 1,  
    	5, 5, 5, 5, 1, 1, 0,21,13, 1
   ]
}