{  
   "tiles":
   [
    	3, 0, 1,12,26,15, 1, 1, 1,18,  
       10, 0, 1, 1,26, 1, 3, 1, 0, 1,
    	7, 1, 1,10,26,11, 1,26, 0, 0,  
    	1,12,26, 1, 0, 1, 1,26, 1, 7,
        0, 1, 1, 1,26, 1,26, 1, 1, 1,  
    	1, 1, 1, 1, 0, 0,18, 1, 4, 1,
	1,10, 1,26, 1, 1, 1,12, 1, 3,  
       11, 1,26, 1, 4, 1, 1,26, 1, 1,
	1, 0, 1, 1, 1, 0, 1, 1,26,15,  
    	4,18, 1, 1,11, 0, 7, 1,15, 2
   ]
}