{  
   "tiles":
   [
       11, 7,12, 6,16, 0, 1, 4, 3,21,  
    	1,10, 1,16, 1, 1,26, 1,13, 1,
       14,17, 0, 1, 1,26, 1, 6, 1, 5,  
    	4,13, 1, 1,26, 1, 1, 3, 1, 1,
        1, 1, 1, 8, 0, 1,12, 1,15, 1,  
       26, 1,15, 1, 1,26, 1, 5, 1,11,
	2,26, 1, 1, 5, 1, 0, 1, 1,17,  
       13, 1,26, 0, 1, 6,26,18, 1, 1,
        3, 0,14, 1,26,26, 1,26, 9,14,  
        7, 9,12, 1,11, 4,14,26, 8, 1
   ]
}