{  
   "tiles":
   [
    	3, 1, 6, 1,26,14, 0, 1, 1,16,  
    	1, 8, 1, 1,26, 1, 1, 1, 1, 1,
    	1, 1, 1, 1,26, 1, 1, 6, 0,14,  
       14, 1, 1,26, 0, 1, 1,11, 1, 1,
        1,11, 1, 0, 1, 3, 1, 1, 1,26,  
    	8,13,16, 0, 2, 0, 1, 1,26, 6,
        1,11, 1, 0,26, 1, 1, 1, 0, 3,  
       14, 1, 1,26, 1, 1,16, 1, 0, 8,
	1, 1, 1,26, 1, 6, 1,26, 1, 1,  
    	3, 6, 1,11,26, 1, 1, 0,21,14
   ]
}