{  
   "tiles":
   [
    	6, 1, 0,12, 3,15, 1,26, 6,15,  
       13, 1, 0, 1,14, 1, 4, 0,26, 0,
        1,15,26,18, 1,11, 1,26, 1, 5,  
    	1,14, 0, 3, 8, 1, 0, 1,10, 1,
        0,26, 0,26, 1,26, 0,16, 1,11,  
    	7, 1,14, 1, 1, 1, 0, 1,15, 4,
       18, 1, 1, 1,17, 1, 1,11, 1, 6,  
    	2,26, 1,13, 1, 0,26,26,26,26,
       12, 0,12, 7, 1,26, 1, 9, 1,10,  
    	3,26, 6, 4, 1,26, 7, 5,14, 7
   ]
}