{  
   "tiles":
   [
    	0, 0, 0, 0, 0, 0, 0, 0, 0, 0,  
    	0, 0, 0, 0, 0, 0, 0, 0, 0, 0,
    	0, 0, 3, 1, 1, 1, 1, 1, 0, 0,
    	0, 0, 1,12,20,11, 1, 1, 0, 0,
	0, 0, 1,20, 2,20, 3, 1, 0, 0,
	0, 0, 1, 1, 1,20, 1, 1, 0, 0,
	0, 0, 1, 1, 1, 4, 1, 1, 0, 0,
	0, 0, 1, 1, 1,11, 1,20, 0, 0,
	0, 0, 0, 0, 0, 0, 0, 0, 0, 0,
	0, 0, 0, 0, 0, 0, 0, 0, 0, 0
   ]
}