{  
   "tiles":
   [
    	2,15, 1,26,18, 5,21, 0,13,10,  
       13, 1, 0, 5, 1,15,10,18,26, 1,
    	0, 1, 1,18, 5, 1,26,13,10, 1,  
       26, 1, 5,13, 1, 1, 1,10, 0,18,
        1,13,18,10, 1,26, 0, 1, 5, 0,  
    	1,10, 1, 1, 1,18,13,26,21, 5,
       10,26,15, 0,13, 1,18, 5, 1, 1,  
        1, 0,10, 1,26, 1, 5, 1,18,13,
	5,18,13, 1, 0,10, 1, 1, 1,26,  
       18, 5,26, 1,10,13, 0,21, 1, 1
   ]
}