{  
   "tiles":
   [
    	6,10,11, 4,18, 0,21,26,12,14,  
       26,16, 4, 4, 0,15,11, 5,16,13,
    	4, 1,13,17,10,26, 1, 8, 1,26,  
       18, 0, 0, 1,12, 1, 8,18, 3, 1,
        7, 1,26, 1, 7,14, 0, 1,26,12,  
    	5,12, 1,16,10, 0, 1, 8,13, 1,
	3,10,15, 6, 0, 8,17, 1,10,26,  
       14, 0, 5, 1,12, 1,10,20, 1, 1,
       21,18, 8,26, 1,11,26, 1, 6,18,  
       16,26,20, 3,18, 7, 4,16,15, 2
   ]
}