{  
   "tiles":
   [
    	3,17, 6, 1,15, 1, 6,11, 0,21,  
    	3, 3,16,26, 6,26,16, 2, 0,21,
       15,26,10,12,26,11, 4,18, 0,17,  
    	9,12,26, 1,18, 1,14, 4, 0,17,
        9, 9,15,26, 1, 8, 1,17, 1,17,  
    	0, 0, 8,12, 1, 7, 0, 4, 7,11,
       11,18, 4, 1, 7,17, 1,16, 1,10,  
       13,13, 0,26,11, 4,15, 1,10,14,
	9, 9,14, 0, 1, 7, 8, 1,12, 3,  
    	9, 9,11,17, 0, 1,12,26, 3, 3
   ]
}