{  
   "tiles":
   [
    	3,12, 5, 1, 1, 1,11, 0,17, 2,  
    	8, 3,14, 8,11, 1, 1, 0, 8,13,
    	3,18,15, 0, 1,10, 5,12, 3, 8,  
       15, 0, 1, 1,26,26,17, 0,18, 7,
        5, 1, 1, 3,17, 1, 1, 1, 0,12,  
    	0,26, 0, 1, 1,15, 1, 1, 1, 3,
       11, 1, 1,26, 1, 1, 1, 1,16,16,  
    	8, 1,11, 0, 1, 1,10,16,13,13,
	5,10, 9,11, 7,11,16,13, 4, 4,  
       18, 9, 9,26, 5, 7,16,13, 4,21
   ]
}