{  
   "tiles":
   [
    	5, 0,15, 8,15, 8,15, 8, 0, 9,  
       11, 0,10, 1, 1, 7, 1, 1, 0,14,
       12, 0,26,26,26,26,26,26, 0, 7,  
    	1,26, 7, 7,18, 8, 8,18, 7, 7,
        1,26,18,16, 0,12, 0,18,16, 7,  
    	7,26, 2,10,15, 3,15, 1, 1, 0,
	1,26,18, 1, 0,12, 0,10,15,10,  
    	1, 0, 4, 1,18, 1,10, 1, 1, 7,
       17, 0,10,15, 4,10, 4,15, 0,13,  
       15, 0,16, 0,16, 0,16,18, 0,21
   ]
}