{  
   "tiles":
   [
    	7, 1, 0, 7, 0, 5, 0, 1,18, 2,  
    	7,14, 1,14, 1,14,13, 1, 4,18,
    	0,15, 1,10, 1,15, 0,15, 4, 4,  
       21, 1, 1,10, 1, 1, 0, 1, 1, 4,
       26,26, 0,26,26,26, 0,26,26,26,  
       12, 1,17, 1, 1,16, 9, 1, 1, 8,
	0, 7,17, 1, 7,16, 9, 1, 1,15,  
    	1,12,12, 0, 0,13,13, 0, 0, 6,
	1, 1, 1, 5, 0,15, 1, 0, 7, 6,  
    	1, 1,15, 5,12, 1, 8, 0,11, 6
   ]
}