{  
   "tiles":
   [
    	8,11, 1, 1,11, 1, 1, 1, 0, 8,  
    	0, 1, 1, 0, 1, 1, 1, 1, 1,12,
       16, 1,10,14, 0, 9, 1, 1, 4, 1,  
       16, 0, 9,13, 2, 0,17,18,17,18,
       16, 0, 4, 6,13, 1, 1, 1, 3, 3,  
       17, 0, 0, 0, 0,26, 0, 0,13, 0,
	5, 0,10,12,12,12, 1, 1,11, 1,  
    	5, 0, 1, 9, 0, 6, 1, 1, 1, 3,
	5, 0, 1, 1, 1, 0, 1, 1, 1, 0,  
    	3, 0, 4, 4, 1,11, 1, 1,14, 8
   ]
}