{  
   "tiles":
   [
    	0, 0, 0, 0, 0, 0, 0, 0, 0, 0,  
    	1, 1, 1, 0, 0, 0, 0, 0, 0, 0,
    	1, 0, 1, 1, 0, 1, 1, 1, 7, 0,
    	1, 0, 0, 1, 1, 1, 1, 1, 0, 0,
       15, 0, 4, 1, 1, 1, 1, 1, 0, 0,
       13, 0, 4, 0, 1, 1, 1, 1,12, 0,
        2, 0, 0, 1, 1, 1, 1, 1, 0, 0,
       12, 0, 1, 1, 0, 1, 1, 1, 1, 0,
	1, 1, 1, 0, 0, 0, 0, 0, 5, 0,
	0, 0, 0, 0, 0, 0, 0, 0, 0, 0
   ]
}