{  
   "tiles":
   [
        3, 0, 1,16, 1, 1,14,26,12, 5,  
       10, 0, 1,12, 1, 1,13,26,16,12,
    	1,26, 1,13, 1, 1,12, 0,26,26,  
       14, 0, 1,14, 1, 1,16,12,13,14,
       18, 0, 1, 1, 1, 1, 1, 1, 1, 1,  
    	1, 2, 1, 1, 1, 1, 1, 1, 0, 0,
	1, 1, 1, 1, 1, 5, 5, 5,11, 7,  
    	0, 0,26, 0, 0, 0,15, 0, 0, 0,
	8, 1,12, 1, 8, 6, 6, 4, 4, 4,  
    	1, 1,13, 1, 8, 6, 6, 4, 4, 4
   ]
}