{  
   "tiles":
   [
       21,11, 0, 4,11, 1, 1, 0,11,21,  
       26,26, 0,11,11, 2, 1, 0,26,26,
       14, 1, 0,26,26,26,26, 0, 1,14,  
       13, 1, 0, 1, 1, 1, 1, 0, 1,13,
       12,16, 0,17, 8, 8,17, 0,16,12,  
       18,16, 0,16,18,18,16, 0,16,18,
	1, 1,26, 1, 1, 1, 1,26, 1, 1,  
    	1, 6,26, 1, 1, 3, 1,26, 6, 1,
	5,10,26, 3, 3, 3, 3,26,10, 5,  
    	8, 8, 0,19,10,10, 4, 0, 8, 8
   ]
}