{  
   "tiles":
   [
    	0, 0, 0, 0, 0, 0, 0, 0, 0, 0,  
    	5, 1, 1, 0, 2, 1, 1, 1, 1, 0,
    	0, 1, 1,20,20, 1, 1, 1, 1, 0,
    	1, 1, 1,20,20, 1, 1, 1,20, 0,
	1,20, 1, 1,20, 1, 1, 1,20, 0,
	1, 1, 1, 1,20,20, 1, 1, 1, 1,
	1, 1, 1, 1,13, 1, 1, 1, 1, 1,
       20, 3, 1, 1,20, 1, 1,11, 1, 0,
	0, 1, 1, 1,20,20, 1, 1, 1, 0,
	0, 0, 0, 0, 0, 0, 0, 0, 0, 0
   ]
}