{  
   "tiles":
   [
       16,17,16, 9, 0, 6, 8,26,10, 1,  
        8, 0,17, 9, 0,10, 9, 0, 1,10,
        0, 0,16, 0, 1, 1, 0, 0, 9, 1,  
    	9, 8, 8,26,17,16,18, 1, 0,13,
        1, 9, 8,11,16,17,16, 9, 0,12,  
    	9, 1, 8, 0, 0,18,17, 0, 8, 8,
	0, 0,26, 0,10, 1, 8, 0, 1, 8,  
       21, 0,17,18,16,10, 0,17,18, 1,
       21,14,17, 0,16, 8,26, 1, 1,16,  
       21,26, 8, 0,16, 0, 2,18,16,16
   ]
}