{  
   "tiles":
   [
    	6, 1, 0, 0, 1, 1, 0, 0, 0, 0,  
    	1, 1, 0, 0, 1, 1, 1, 0, 0, 0,
    	0, 1, 1, 1, 1, 1, 1, 1, 1, 0,
       17, 1, 1, 1, 1, 1, 1, 1, 0, 0,
	0, 1, 1, 2, 1, 1, 1, 1, 0, 0,
       18, 1, 1, 1, 1, 1, 1, 1, 1, 0,
	0, 1, 1, 1,14, 1, 1, 1, 1,10,
	0, 0, 1, 1, 1, 1, 1, 1, 1, 1,
	0, 0, 0, 1, 1, 0, 1, 1, 0, 0,
	0, 0, 0, 0, 0, 0, 1, 9, 0, 0
   ]
}