{  
   "tiles":
   [
    	0, 0, 0, 0, 0, 0, 0, 0, 0, 0,  
    	0, 0, 0, 2, 0, 0, 0, 0, 0, 0,
    	0, 0, 1, 1, 1, 1, 1,12, 1, 0,
    	0, 0, 4, 1, 1, 1, 1, 1, 1, 0,
	0, 0, 0,15, 0, 1, 1,13, 0, 0,
	0, 0, 1, 1, 1,13, 0, 0, 0, 0,
	0, 0, 1, 1, 1, 1, 1, 1, 5, 0,
	0, 0, 7, 1, 1, 1, 1, 5, 1, 0,
	0, 0, 0, 1, 1, 0, 0, 0, 0, 0,
	0, 0, 0, 0, 0, 0, 0, 0, 0, 0
   ]
}