{  
   "tiles":
   [
    	1, 1, 6, 1, 1, 1, 6, 1, 1, 1,  
    	1, 1,18, 1, 1, 1, 1,14, 1, 1,
       10, 1, 1, 1, 2, 1,18, 1, 6, 1,
    	1,14, 1, 1, 1, 1, 1, 1, 1, 1,
	1, 1, 1, 1,14, 1, 1, 1, 1, 6,
	1, 6, 1, 1, 1, 1, 1, 0, 0, 0,
       14, 1, 1, 1, 1, 1,10, 1, 1,10,
       18, 0, 1,14, 1, 1, 1,14, 1, 1,
	0, 0, 1, 1, 0, 1, 1, 1, 1, 1,
	0, 0, 1,18, 0,10, 1, 1, 6, 1,
   ]
}