{  
   "tiles":
   [
    	0, 3, 0, 0, 1, 1, 0, 0, 6, 1,  
    	1, 1, 0, 1, 1, 1, 0, 0, 8, 1,
    	1, 1, 1,12, 1, 1, 1, 1,13, 1,
    	1, 1, 1, 1, 1, 1, 1, 1, 0, 0,
	0, 1, 1, 1, 1,14, 1, 1, 0, 0,
	0, 0, 0, 1, 1, 1, 1,11, 1, 1,
	0, 0, 1, 1, 1, 1, 1, 1, 1, 0,
	5, 1, 1, 1, 1, 1, 1, 1, 1, 1,
	0, 4, 1, 0, 0, 0, 1, 0, 1, 1,
	0, 0, 1, 0, 0, 0, 0, 2,16, 0
   ]
}